35 29
11101010111111111111111110101110101
00101010100010000000000000101000101
11111110101011101011111011111111101
00001010101000101010000000100010001
11101010111010111110101011101111101
10101000001010101000101010000010101
10101010111110101111101011111010101
10001010001000001010101000101000001
11111011111011101010111111101111101
00100000100000100010100000001010101
11111011111010111110101111111010111
00001000101010001000101010100000100
10101111101011111110101010101111111
10101000000000100000000000000010101
10111010101011111111101111101110101
10100010101000100000000000100010100
10101010111011101111101011111110111
10101010101010100010101000000010000
11101111101010101010101011101111101
10100010000000101000101010000000001
10101111101110111110111011111010111
10100010001000001010100010000010100
10101010111110101011111110111011111
00001010100000100010001010001010001
10111011111110101110111010101011101
10100000100000101010000000101000001
11111111111111111011101111101010111
10000000000010001000100010101010001
11101111111110111011111110111111111